coronal_index,sagittal_index,index,ap_um,ml_um,dv_um,depth_um,elevation,azimuth
1807,5039,1,-5250,986,-390,5950,73,180
1807,5019,1,-5250,464,-463,5873,73,180
1807,4968,1,-5250,-804,-368,5655,80,180
1807,4923,1,-5250,-1913,-987,4543,80,180
1825,5037,1,-4750,920,-320,6073,73,180
1825,5018,1,-4750,449,-226,6122,73,180
1825,4966,1,-4750,-846,-320,5510,80,180
1825,4948,1,-4750,-1300,-59,5485,80,180
1825,4928,1,-4750,-1800,-59,4975,80,180
1825,4908,1,-4750,-2300,-59,3939,80,180
1825,4887,1,-4750,-2829,-226,4398,80,180
1825,4864,1,-4750,-3396,-606,3867,80,180
1844,5040,1,-4250,1000,226,6545,73,180
1844,5014,1,-4250,347,-273,5853,73,180
1844,4968,1,-4250,-800,226,5839,80,180
1844,4948,1,-4250,-1300,226,5872,80,180
1844,4908,1,-4250,-2304,203,5461,80,180
1844,4886,1,-4250,-2846,-35,5124,80,180
1844,4864,1,-4250,-3405,-368,4543,80,180
1844,4840,1,-4250,-3997,-891,3552,80,180
1862,5040,1,-3750,1000,417,6445,73,180
1862,5020,1,-3750,493,394,6322,73,180
1862,4968,1,-3750,-800,417,5534,80,180
1862,4948,1,-3750,-1300,417,5050,80,180
1862,4928,1,-3750,-1804,393,5945,80,180
1862,4863,1,-3750,-3413,-225,4930,80,180
1862,4840,1,-3750,-3997,-701,3915,80,180
1880,5040,1,-3250,1000,512,5350,73,180
1880,5020,1,-3250,500,512,5749,73,180
1880,4968,1,-3250,-800,512,5292,80,180
1880,4948,1,-3250,-1300,512,5872,80,180
1880,4927,1,-3250,-1813,441,6428,80,180
1880,4906,1,-3250,-2338,298,6198,80,180
1880,4885,1,-3250,-2871,108,5897,80,180
1880,4863,1,-3250,-3413,-130,5268,80,180
1880,4840,1,-3250,-3997,-606,4128,80,180
1899,5040,1,-2750,1000,560,6196,73,180
1899,5020,1,-2750,500,560,5848,73,180
1899,4968,1,-2750,-800,560,5872,80,180
1899,4948,1,-2750,-1304,536,6331,80,180
1899,4927,1,-2750,-1821,441,6622,80,180
1899,4906,1,-2750,-2346,299,6429,80,180
1899,4885,1,-2750,-2880,108,6090,80,180
1899,4863,1,-2750,-3430,-178,5365,80,180
1899,4840,1,-2750,-3997,-558,4128,80,180
1917,5040,1,-2250,1000,560,6694,73,180
1917,5020,1,-2250,493,537,6222,73,180
1917,4968,1,-2250,-800,560,6210,80,180
1917,4948,1,-2250,-1304,536,6621,80,180
1917,4927,1,-2250,-1821,441,6864,80,180
1917,4906,1,-2250,-2346,299,6670,80,180
1917,4885,1,-2250,-2880,108,6186,80,180
1917,4863,1,-2250,-3430,-178,5365,80,180
1917,4840,1,-2250,-4006,-606,4079,80,180
1936,5040,1,-1750,993,489,6820,73,180
1936,5020,1,-1750,493,489,6272,73,180
1936,4968,1,-1750,-800,512,6452,80,180
1936,4947,1,-1750,-1313,441,6718,80,180
1936,4927,1,-1750,-1821,394,6912,80,180
1936,4906,1,-1750,-2346,251,6719,80,180
1936,4884,1,-1750,-2888,13,6090,80,180
1936,4863,1,-1750,-3430,-226,5123,80,180
1936,4840,1,-1750,-4006,-654,3866,80,180
1954,5039,1,-1250,986,419,6747,73,180
1954,5020,1,-1250,493,441,6421,73,180
1954,4968,1,-1250,-804,441,6573,80,180
1954,4947,1,-1250,-1313,393,6815,80,180
1954,4927,1,-1250,-1829,298,6815,80,180
1954,4906,1,-1250,-2355,155,6573,80,180
1954,4884,1,-1250,-2888,-35,5897,80,180
1954,4862,1,-1250,-3438,-320,4882,80,180
1954,4839,1,-1250,-4022,-796,3625,80,180
1972,5039,1,-750,978,298,6643,73,180
1972,5019,1,-750,478,298,6421,73,180
1972,4967,1,-750,-813,298,6573,80,180
1972,4947,1,-750,-1313,298,6767,80,180
1972,4927,1,-750,-1821,251,6767,80,180
1972,4906,1,-750,-2355,60,6331,80,180
1972,4884,1,-750,-2896,-177,5462,80,180
1972,4862,1,-750,-3447,-463,4418,80,180
1991,5040,1,-250,993,203,6522,73,180
1991,5019,1,-250,478,156,6371,73,180
1991,4968,1,-250,-804,203,6476,80,180
1991,4948,1,-250,-1304,203,6525,80,180
1991,4927,1,-250,-1821,108,6477,80,180
1991,4906,1,-250,-2355,-83,5993,80,180
1991,4884,1,-250,-2896,-320,5027,80,180
1991,4862,1,-250,-3447,-606,4157,80,180
2009,5039,1,250,978,13,6172,73,180
2009,5019,1,250,478,13,6570,73,180
2009,4968,1,250,-804,60,6525,80,180
2009,4947,1,250,-1313,13,6332,80,180
2009,4927,1,250,-1829,-83,5945,80,180
2009,4905,1,250,-2363,-273,5462,80,180
2009,4884,1,250,-2896,-463,4708,80,180
2009,4862,1,250,-3455,-797,3818,80,180
2028,5039,1,750,978,-130,6222,73,180
2028,5019,1,750,478,-130,6421,73,180
2028,4968,1,750,-804,-83,6380,80,180
2028,4947,1,750,-1321,-177,6042,80,180
2028,4926,1,750,-1846,-320,5414,80,180
2028,4905,1,750,-2371,-463,4979,80,180
2028,4883,1,750,-2913,-701,4323,80,180
2046,5039,1,1250,978,-225,6172,73,180
2046,5019,1,1250,464,-273,6222,73,180
2046,4967,1,1250,-813,-225,6090,80,180
2046,4947,1,1250,-1321,-273,5719,80,180
2046,4926,1,1250,-1855,-464,5026,80,180
2046,4904,1,1250,-2396,-701,4420,80,180
2046,4882,1,1250,-2947,-987,3674,80,180
2064,5039,1,1750,978,-368,5824,73,180
2064,5019,1,1750,464,-416,5774,73,180
2064,4967,1,1750,-813,-368,5558,80,180
2064,4904,1,1750,-2405,-892,3915,80,180
2083,5018,1,2250,449,-606,5127,73,180
2101,5017,1,2750,420,-891,4563,73,180
1733,5032,1,-7250,800,-488,5920,80,180
1733,5052,1,-7250,1296,-511,5896,80,180
1733,5071,1,-7250,1779,-606,5897,80,180
1733,5089,1,-7250,2237,-844,5558,80,180
1733,5108,1,-7250,2704,-1034,5124,80,180
1733,5125,1,-7250,3136,-1415,4398,80,180
1752,5032,1,-6750,800,-202,6259,80,180
1752,5050,1,-6750,1254,-463,5994,80,180
1752,5071,1,-6750,1771,-368,6090,80,180
1752,5089,1,-6750,2236,-564,5746,80,180
1752,5107,1,-6750,2686,-848,5264,80,180
1752,5125,1,-6750,3136,-1130,4737,80,180
1770,5031,1,-6250,787,-178,6235,80,180
1770,5050,1,-6250,1245,-416,5993,80,180
1770,5070,1,-6250,1745,-416,5945,80,180
1770,5089,1,-6250,2229,-511,5752,80,180
1770,5107,1,-6250,2687,-749,5317,80,180
1770,5125,1,-6250,3136,-1034,4737,80,180
1788,5031,1,-5750,787,-273,6042,80,180
1788,5051,1,-5750,1271,-368,5945,80,180
1788,5069,1,-5750,1720,-654,5606,80,180
1788,5088,1,-5750,2195,-797,5413,80,180
1788,5107,1,-5750,2670,-940,5123,80,180
1788,5125,1,-5750,3120,-1225,4495,80,180
1798,4968,0,-5500,-800,-345,4000,75,0
1798,4948,0,-5500,-1294,-368,4000,75,0
1798,4931,0,-5500,-1714,-665,4000,75,0
1798,4917,0,-5500,-2064,-1225,4000,75,0
1798,4899,0,-5500,-2514,-1412,4000,75,0
1798,4883,0,-5500,-2937,-1701,4000,75,0
1816,4971,0,-5000,-717,-368,4000,75,0
1816,4954,0,-5000,-1141,-653,4000,75,0
1816,4928,0,-5000,-1794,-82,4000,75,0
1816,4909,0,-5000,-2281,-130,4000,75,0
1816,4891,0,-5000,-2730,-321,4000,75,0
1816,4873,0,-5000,-3166,-559,4000,75,0
1834,4973,0,-4500,-679,-226,4000,75,0
1834,4948,0,-4500,-1300,226,4000,75,0
1834,4928,0,-4500,-1800,226,4000,75,0
1834,4909,0,-4500,-2268,108,4000,75,0
1834,4891,0,-4500,-2717,-83,4000,75,0
1834,4826,0,-4500,-4360,-1416,3597,75,0
1853,4968,0,-4000,-794,394,4000,75,0
1853,4948,0,-4000,-1294,394,4000,75,0
1853,4929,0,-4000,-1781,346,4000,75,0
1853,4910,0,-4000,-2255,251,4000,75,0
1853,4892,0,-4000,-2704,60,4000,75,0
1853,4874,0,-4000,-3154,-130,4000,75,0
1853,4857,0,-4000,-3577,-416,4000,75,0
1853,4841,0,-4000,-3975,-796,4000,75,0
1853,4825,0,-4000,-4364,-1210,4000,75,0
1871,4968,0,-3500,-800,512,4000,75,0
1871,4948,0,-3500,-1300,512,4000,75,0
1871,4929,0,-3500,-1781,441,4000,75,0
1871,4910,0,-3500,-2243,299,4000,75,0
1871,4892,0,-3500,-2704,156,4000,75,0
1871,4874,0,-3500,-3154,-35,4000,75,0
1871,4857,0,-3500,-3577,-321,4000,75,0
1890,4968,0,-3000,-800,560,4000,75,0
1890,4948,0,-3000,-1300,560,4000,75,0
1890,4929,0,-3000,-1768,441,4000,75,0
1890,4910,0,-3000,-2243,346,4000,75,0
1890,4892,0,-3000,-2704,203,4000,75,0
1890,4874,0,-3000,-3154,13,4000,75,0
1890,4857,0,-3000,-3577,-273,4000,75,0
1908,4968,0,-2500,-800,560,4000,75,0
1908,4948,0,-2500,-1294,536,4000,75,0
1908,4929,0,-2500,-1768,441,4000,75,0
1908,4910,0,-2500,-2243,346,4000,75,0
1908,4892,0,-2500,-2704,203,4000,75,0
1908,4874,0,-2500,-3154,13,4000,75,0
1908,4857,0,-2500,-3577,-273,4000,75,0
1926,4968,0,-2000,-800,512,4000,75,0
1926,4948,0,-2000,-1294,489,4000,75,0
1926,4929,0,-2000,-1768,393,4000,75,0
1926,4910,0,-2000,-2243,299,4000,75,0
1926,4892,0,-2000,-2704,156,4000,75,0
1926,4874,0,-2000,-3154,-35,4000,75,0
1926,4857,0,-2000,-3577,-321,4000,75,0
1945,4968,0,-1500,-800,464,4000,75,0
1945,4948,0,-1500,-1294,441,4000,75,0
1945,4929,0,-1500,-1768,346,4000,75,0
1945,4910,0,-1500,-2243,251,4000,75,0
1945,4892,0,-1500,-2704,108,4000,75,0
1945,4874,0,-1500,-3141,-130,4000,75,0
1945,4857,0,-1500,-3577,-368,4000,75,0
1963,4968,0,-1000,-800,369,4000,75,0
1963,4948,0,-1000,-1294,346,4000,75,0
1963,4929,0,-1000,-1781,299,4000,75,0
1963,4910,0,-1000,-2243,156,4000,75,0
1963,4892,0,-1000,-2692,-35,4000,75,0
1963,4874,0,-1000,-3141,-225,4000,75,0
1963,4857,0,-1000,-3564,-511,4000,75,0
1982,4968,0,-500,-800,226,4000,75,0
1982,4948,0,-500,-1300,226,4000,75,0
1982,4929,0,-500,-1781,156,4000,75,0
1982,4910,0,-500,-2255,60,4000,75,0
1982,4892,0,-500,-2704,-130,4000,75,0
1982,4874,0,-500,-3141,-368,4000,75,0
2000,4968,0,0,-800,84,4000,75,0
2000,4948,0,0,-1300,84,4000,75,0
2000,4929,0,0,-1781,13,4000,75,0
2000,4910,0,0,-2243,-130,4000,75,0
2000,4892,0,0,-2704,-273,4000,75,0
2000,4874,0,0,-3141,-510,4000,75,0
2018,4968,0,500,-800,-59,4000,75,0
2018,4948,0,500,-1294,-82,4000,75,0
2018,4929,0,500,-1768,-178,4000,75,0
2018,4911,0,500,-2230,-321,4000,75,0
2018,4892,0,500,-2692,-463,4000,75,0
2018,4875,0,500,-3128,-702,4000,75,0
2037,4968,0,1000,-800,-154,4000,75,0
2037,4949,0,1000,-1281,-225,4000,75,0
2037,4930,0,1000,-1743,-368,4000,75,0
2037,4912,0,1000,-2204,-511,4000,75,0
2037,4894,0,1000,-2654,-701,4000,75,0
2055,4968,0,1500,-800,-297,4000,75,0
2055,4949,0,1500,-1281,-368,4000,75,0
2055,4930,0,1500,-1743,-511,4000,75,0
2055,4912,0,1500,-2192,-701,4000,75,0
2055,4895,0,1500,-2628,-940,4000,75,0
2055,4877,0,1500,-3064,-1177,4000,75,0
2055,4861,0,1500,-3464,-1551,4000,75,0
2074,4968,0,2000,-800,-440,4000,75,0
2074,4949,0,2000,-1281,-511,4000,75,0
2074,4930,0,2000,-1743,-653,4000,75,0
2074,4912,0,2000,-2192,-844,4000,75,0
2074,4895,0,2000,-2615,-1130,4000,75,0
2074,4879,0,2000,-3014,-1507,3946,75,0
2092,4968,0,2500,-800,-630,4000,75,0
2092,4949,0,2500,-1281,-701,4000,75,0
2092,4930,0,2500,-1743,-844,4000,75,0
2092,4912,0,2500,-2192,-1034,4000,75,0
2092,4895,0,2500,-2614,-1324,3791,75,0
2110,4968,0,3000,-800,-868,4000,75,0
2110,4948,0,3000,-1294,-892,4000,75,0
2110,4930,0,3000,-1755,-1035,4000,75,0
2110,4912,0,3000,-2192,-1272,3844,75,0
1724,5012,0,-7500,300,-488,4000,75,0
1724,5032,0,-7500,806,-511,4000,75,0
1724,5055,0,-7500,1370,-749,4000,75,0
1742,5012,0,-7000,300,-202,4000,75,0
1742,5033,0,-7000,832,-321,4000,75,0
1742,5055,0,-7000,1370,-464,4000,75,0
1742,5075,0,-7000,1883,-511,3875,75,0
1761,5012,0,-6500,300,-107,4000,75,0
1761,5032,0,-6500,806,-130,4000,75,0
1761,5056,0,-6500,1408,-511,4000,75,0
1761,5075,0,-6500,1870,-369,4000,75,0
1761,5098,0,-6500,2446,-654,4000,75,0
1761,5121,0,-6500,3023,-939,4000,75,0
1779,5012,0,-6000,300,-202,4000,75,0
1779,5033,0,-6000,832,-321,4000,75,0
1779,5055,0,-6000,1370,-464,4000,75,0
1779,5076,0,-6000,1896,-558,4000,75,0
1779,5097,0,-6000,2421,-654,4000,75,0
1779,5120,0,-6000,3010,-987,4000,75,0
