coronal_index,sagittal_index,index,ap_um,ml_um,dv_um,depth_um,theta,phi
1614,5078,1,-5250,975,-847,5923,17,0
1614,5037,1,-5250,460,-894,5874,17,0
1614,4935,1,-5250,-815,-847,5631,10,0
1614,4846,1,-5250,-1924,-1465,4496,10,0
1650,5073,1,-4750,909,-800,6022,17,0
1650,5036,1,-4750,446,-680,6147,17,0
1650,4932,1,-4750,-844,-751,5559,10,0
1650,4896,1,-4750,-1300,-502,5473,10,0
1650,4856,1,-4750,-1800,-502,5047,10,0
1650,4774,1,-4750,-2827,-657,4326,10,0
1650,4728,1,-4750,-3394,-1037,3843,10,0
1687,5080,1,-4250,1000,-193,6557,17,0
1687,5028,1,-4250,351,-681,5898,17,0
1687,4936,1,-4250,-800,-193,5884,10,0
1687,4896,1,-4250,-1300,-193,5911,10,0
1687,4815,1,-4250,-2310,-252,5438,10,0
1687,4772,1,-4250,-2848,-466,5148,10,0
1687,4727,1,-4250,-3407,-799,4567,10,0
1687,4680,1,-4250,-3995,-1299,3636,10,0
1724,5080,1,-3750,1000,-2,6483,17,0
1724,5039,1,-3750,489,-38,6321,17,0
1724,4936,1,-3750,-800,-2,5570,10,0
1724,4896,1,-3750,-1300,-2,5014,10,0
1724,4855,1,-3750,-1806,-38,5921,10,0
1724,4727,1,-3750,-3415,-656,4959,10,0
1724,4680,1,-3750,-3995,-1108,4036,10,0
1761,5080,1,-3250,1000,93,5363,17,0
1761,5040,1,-3250,500,93,5736,17,0
1761,4936,1,-3250,-800,93,5335,10,0
1761,4896,1,-3250,-1300,93,5812,10,0
1761,4855,1,-3250,-1815,10,6404,10,0
1761,4813,1,-3250,-2340,-133,6235,10,0
1761,4770,1,-3250,-2873,-323,5897,10,0
1761,4726,1,-3250,-3419,-585,5293,10,0
1761,4680,1,-3250,-3995,-1013,4212,10,0
1798,5080,1,-2750,1000,140,6234,17,0
1798,5040,1,-2750,500,140,5905,17,0
1798,4936,1,-2750,-800,140,5908,10,0
1798,4895,1,-2750,-1306,105,6356,10,0
1798,4854,1,-2750,-1823,10,6622,10,0
1798,4812,1,-2750,-2348,-132,6453,10,0
1798,4769,1,-2750,-2882,-323,6138,10,0
1798,4726,1,-2750,-3424,-561,5414,10,0
1798,4680,1,-2750,-3999,-989,4206,10,0
1834,5080,1,-2250,1000,140,6707,17,0
1834,5039,1,-2250,489,105,6247,17,0
1834,4936,1,-2250,-800,140,6223,10,0
1834,4895,1,-2250,-1306,105,6597,10,0
1834,4854,1,-2250,-1823,10,6840,10,0
1834,4812,1,-2250,-2348,-132,6695,10,0
1834,4769,1,-2250,-2882,-323,6211,10,0
1834,4725,1,-2250,-3432,-609,5365,10,0
1834,4679,1,-2250,-4008,-1037,4139,10,0
1871,5079,1,-1750,989,57,6844,17,0
1871,5039,1,-1750,489,57,6296,17,0
1871,4936,1,-1750,-800,93,6440,10,0
1871,4895,1,-1750,-1315,10,6694,10,0
1871,4854,1,-1750,-1823,-37,6888,10,0
1871,4812,1,-1750,-2348,-180,6719,10,0
1871,4769,1,-1750,-2886,-395,6136,10,0
1871,4725,1,-1750,-3432,-657,5196,10,0
1871,4679,1,-1750,-4012,-1109,3915,10,0
1908,5078,1,-1250,975,-38,6719,17,0
1908,5039,1,-1250,482,-14,6441,17,0
1908,4935,1,-1250,-806,10,6549,10,0
1908,4895,1,-1250,-1315,-38,6815,10,0
1908,4853,1,-1250,-1831,-133,6839,10,0
1908,4811,1,-1250,-2357,-276,6573,10,0
1908,4769,1,-1250,-2890,-466,5897,10,0
1908,4725,1,-1250,-3440,-752,4930,10,0
1908,4678,1,-1250,-4020,-1204,3674,10,0
1945,5079,1,-750,982,-133,6670,17,0
1945,5039,1,-750,482,-133,6441,17,0
1945,4935,1,-750,-810,-133,6598,10,0
1945,4895,1,-750,-1310,-133,6767,10,0
1945,4854,1,-750,-1823,-204,6743,10,0
1945,4812,1,-750,-2348,-347,6356,10,0
1945,4769,1,-750,-2890,-585,5536,10,0
1945,4725,1,-750,-3440,-871,4526,10,0
1982,5079,1,-250,982,-252,6545,17,0
1982,5038,1,-250,475,-276,6421,17,0
1982,4935,1,-250,-810,-252,6453,10,0
1982,4895,1,-250,-1315,-276,6453,10,0
1982,4854,1,-250,-1823,-323,6477,10,0
1982,4811,1,-250,-2357,-514,5993,10,0
1982,4768,1,-250,-2894,-728,5100,10,0
1982,4724,1,-250,-3449,-1037,4190,10,0
2018,5079,1,250,982,-395,6222,17,0
2018,5038,1,250,475,-419,6570,17,0
2018,4935,1,250,-810,-395,6501,10,0
2018,4895,1,250,-1315,-418,6332,10,0
2018,4853,1,250,-1831,-514,5969,10,0
2018,4811,1,250,-2361,-680,5510,10,0
2018,4768,1,250,-2898,-894,4768,10,0
2018,4723,1,250,-3461,-1251,3867,10,0
2055,5078,1,750,975,-562,6097,17,0
2055,5038,1,750,475,-562,6445,17,0
2055,4935,1,750,-810,-537,6380,10,0
2055,4894,1,750,-1323,-608,6067,10,0
2055,4852,1,750,-1844,-728,5438,10,0
2055,4810,1,750,-2373,-894,4979,10,0
2055,4767,1,750,-2915,-1132,4374,10,0
2092,5079,1,1250,982,-657,6197,17,0
2092,5037,1,1250,468,-704,6222,17,0
2092,4935,1,1250,-810,-656,6114,10,0
2092,4894,1,1250,-1323,-727,5752,10,0
2092,4852,1,1250,-1852,-895,5051,10,0
2092,4808,1,1250,-2394,-1132,4471,10,0
2092,4765,1,1250,-2940,-1394,3770,10,0
2129,5079,1,1750,982,-799,5823,17,0
2129,5037,1,1750,468,-846,5799,17,0
2129,4935,1,1750,-810,-799,5583,10,0
2129,4808,1,1750,-2398,-1299,3988,10,0
2166,5036,1,2250,453,-1037,5127,17,0
2202,5035,1,2750,438,-1275,4629,17,0
1466,5064,1,-7250,800,-907,5957,10,0
1466,5103,1,-7250,1290,-966,5921,10,0
1466,5141,1,-7250,1764,-1109,5824,10,0
1466,5178,1,-7250,2227,-1322,5511,10,0
1466,5216,1,-7250,2697,-1490,5123,10,0
1466,5250,1,-7250,3124,-1907,4288,10,0
1503,5064,1,-6750,800,-645,6247,10,0
1503,5100,1,-6750,1252,-918,5970,10,0
1503,5141,1,-6750,1769,-823,6066,10,0
1503,5178,1,-6750,2231,-1037,5728,10,0
1503,5214,1,-6750,2681,-1323,5196,10,0
1503,5251,1,-6750,3134,-1585,4689,10,0
1540,5063,1,-6250,785,-609,6235,10,0
1540,5099,1,-6250,1243,-847,5993,10,0
1540,5139,1,-6250,1743,-847,5945,10,0
1540,5178,1,-6250,2224,-959,5734,10,0
1540,5214,1,-6250,2681,-1204,5293,10,0
1540,5251,1,-6250,3134,-1466,4689,10,0
1577,5062,1,-5750,781,-728,6018,10,0
1577,5101,1,-5750,1269,-799,5945,10,0
1577,5136,1,-5750,1706,-1156,5559,10,0
1577,5175,1,-5750,2193,-1228,5413,10,0
1577,5213,1,-5750,2664,-1394,5099,10,0
1577,5249,1,-5750,3109,-1704,4447,10,0
1595,4936,0,-5500,-800,-764,4000,15,180
1595,4897,0,-5500,-1284,-823,4000,15,180
1595,4863,0,-5500,-1708,-1109,4000,15,180
1595,4834,0,-5500,-2077,-1598,4000,15,180
1595,4799,0,-5500,-2516,-1823,4000,15,180
1595,4765,0,-5500,-2934,-2132,4000,15,180
1632,4942,0,-5000,-721,-799,4000,15,180
1632,4908,0,-5000,-1152,-1056,4000,15,180
1632,4856,0,-5000,-1797,-514,4000,15,180
1632,4817,0,-5000,-2284,-561,4000,15,180
1632,4781,0,-5000,-2733,-751,4000,15,180
1632,4746,0,-5000,-3169,-990,4000,15,180
1669,4946,0,-4500,-676,-656,4000,15,180
1669,4896,0,-4500,-1297,-204,4000,15,180
1669,4856,0,-4500,-1797,-204,4000,15,180
1669,4819,0,-4500,-2265,-323,4000,15,180
1669,4783,0,-4500,-2714,-513,4000,15,180
1669,4652,0,-4500,-4352,-1866,3577,15,180
1706,4937,0,-4000,-791,-37,4000,15,180
1706,4896,0,-4000,-1297,-14,4000,15,180
1706,4857,0,-4000,-1784,-61,4000,15,180
1706,4820,0,-4000,-2252,-180,4000,15,180
1706,4784,0,-4000,-2702,-369,4000,15,180
1706,4748,0,-4000,-3150,-562,4000,15,180
1706,4714,0,-4000,-3577,-836,4000,15,180
1706,4682,0,-4000,-3978,-1204,4000,15,180
1706,4650,0,-4000,-4370,-1609,4000,15,180
1742,4936,0,-3500,-800,93,4000,15,180
1742,4896,0,-3500,-1300,93,4000,15,180
1742,4858,0,-3500,-1778,10,4000,15,180
1742,4820,0,-3500,-2246,-109,4000,15,180
1742,4784,0,-3500,-2701,-275,4000,15,180
1742,4748,0,-3500,-3150,-466,4000,15,180
1742,4714,0,-3500,-3580,-728,4000,15,180
1779,4936,0,-3000,-800,140,4000,15,180
1779,4896,0,-3000,-1297,129,4000,15,180
1779,4858,0,-3000,-1772,34,4000,15,180
1779,4821,0,-3000,-2239,-86,4000,15,180
1779,4784,0,-3000,-2701,-228,4000,15,180
1779,4748,0,-3000,-3150,-419,4000,15,180
1779,4714,0,-3000,-3580,-681,4000,15,180
1816,4936,0,-2500,-800,140,4000,15,180
1816,4897,0,-2500,-1291,106,4000,15,180
1816,4859,0,-2500,-1765,10,4000,15,180
1816,4821,0,-2500,-2239,-86,4000,15,180
1816,4784,0,-2500,-2701,-228,4000,15,180
1816,4748,0,-2500,-3150,-419,4000,15,180
1816,4714,0,-2500,-3577,-693,4000,15,180
1853,4936,0,-2000,-800,93,4000,15,180
1853,4897,0,-2000,-1291,58,4000,15,180
1853,4858,0,-2000,-1772,-13,4000,15,180
1853,4821,0,-2000,-2239,-133,4000,15,180
1853,4784,0,-2000,-2701,-275,4000,15,180
1853,4748,0,-2000,-3150,-466,4000,15,180
1853,4714,0,-2000,-3580,-728,4000,15,180
1890,4936,0,-1500,-800,45,4000,15,180
1890,4897,0,-1500,-1291,10,4000,15,180
1890,4859,0,-1500,-1765,-85,4000,15,180
1890,4821,0,-1500,-2239,-181,4000,15,180
1890,4784,0,-1500,-2695,-347,4000,15,180
1890,4748,0,-1500,-3144,-537,4000,15,180
1890,4714,0,-1500,-3577,-788,4000,15,180
1926,4936,0,-1000,-800,-74,4000,15,180
1926,4896,0,-1000,-1297,-85,4000,15,180
1926,4857,0,-1000,-1784,-133,4000,15,180
1926,4820,0,-1000,-2246,-276,4000,15,180
1926,4784,0,-1000,-2701,-442,4000,15,180
1926,4748,0,-1000,-3150,-633,4000,15,180
1926,4714,0,-1000,-3580,-895,4000,15,180
1963,4936,0,-500,-800,-193,4000,15,180
1963,4896,0,-500,-1300,-193,4000,15,180
1963,4857,0,-500,-1784,-252,4000,15,180
1963,4820,0,-500,-2246,-395,4000,15,180
1963,4784,0,-500,-2701,-561,4000,15,180
1963,4748,0,-500,-3144,-775,4000,15,180
2000,4936,0,0,-800,-336,4000,15,180
2000,4896,0,0,-1297,-347,4000,15,180
2000,4858,0,0,-1778,-419,4000,15,180
2000,4821,0,0,-2239,-562,4000,15,180
2000,4784,0,0,-2695,-728,4000,15,180
2000,4749,0,0,-3137,-942,4000,15,180
2037,4936,0,500,-800,-478,4000,15,180
2037,4897,0,500,-1291,-513,4000,15,180
2037,4859,0,500,-1765,-609,4000,15,180
2037,4821,0,500,-2233,-728,4000,15,180
2037,4785,0,500,-2688,-895,4000,15,180
2037,4750,0,500,-3125,-1132,4000,15,180
2074,4936,0,1000,-800,-597,4000,15,180
2074,4897,0,1000,-1284,-656,4000,15,180
2074,4860,0,1000,-1752,-778,4000,15,180
2074,4824,0,1000,-2202,-964,4000,15,180
2074,4787,0,1000,-2657,-1133,4000,15,180
2110,4936,0,1500,-800,-740,4000,15,180
2110,4897,0,1500,-1291,-775,4000,15,180
2110,4860,0,1500,-1752,-921,4000,15,180
2110,4824,0,1500,-2201,-1108,4000,15,180
2110,4789,0,1500,-2637,-1347,4000,15,180
2110,4755,0,1500,-3067,-1609,4000,15,180
2110,4722,0,1500,-3478,-1942,4000,15,180
2147,4936,0,2000,-797,-895,4000,15,180
2147,4897,0,2000,-1284,-942,4000,15,180
2147,4860,0,2000,-1746,-1085,4000,15,180
2147,4824,0,2000,-2195,-1275,4000,15,180
2147,4790,0,2000,-2625,-1537,4000,15,180
2147,4758,0,2000,-3029,-1894,4000,15,180
2184,4936,0,2500,-800,-1073,4000,15,180
2184,4897,0,2500,-1291,-1108,4000,15,180
2184,4860,0,2500,-1746,-1275,4000,15,180
2184,4824,0,2500,-2195,-1466,4000,15,180
2184,4791,0,2500,-2612,-1775,3820,15,180
2221,4936,0,3000,-797,-1299,4000,15,180
2221,4897,0,3000,-1291,-1322,4000,15,180
2221,4860,0,3000,-1752,-1468,4000,15,180
2221,4825,0,3000,-2188,-1704,3868,15,180
1448,5024,0,-7500,300,-907,4000,15,180
1448,5065,0,-7500,816,-966,4000,15,180
1448,5110,0,-7500,1373,-1180,4000,15,180
1485,5024,0,-7000,300,-645,4000,15,180
1485,5066,0,-7000,828,-751,4000,15,180
1485,5110,0,-7000,1379,-942,4000,15,180
1485,5151,0,-7000,1892,-990,3794,15,180
1485,5199,0,-7000,2482,-1323,4000,15,180
1522,5024,0,-6500,300,-526,4000,15,180
1522,5065,0,-6500,809,-561,4000,15,180
1522,5112,0,-6500,1405,-918,4000,15,180
1522,5150,0,-6500,1879,-823,4000,15,180
1522,5197,0,-6500,2463,-1133,4000,15,180
1522,5243,0,-6500,3033,-1394,4000,15,180
1558,5024,0,-6000,300,-621,4000,15,180
1558,5067,0,-6000,841,-776,4000,15,180
1558,5111,0,-6000,1386,-942,4000,15,180
1558,5151,0,-6000,1892,-966,4000,15,180
1558,5194,0,-6000,2424,-1085,4000,15,180
1558,5243,0,-6000,3039,-1513,4000,15,180
